europe = {
	provinces = {
		251 252 253 254 255 256 257 258 259 260 261 262 263 264 265 266 267 268 269 270 271 272 273 274 275 276 277 278
		279 280 281 282 283 284 285 286 287 288 289 290 291 292 293 294 295 296 297 298 299 300 301 302 303 304 305 306
		307 308 309 310 311 312 313 314 315 316 317 318 319 320 321 322 323 324 325 326 327 328 329 330 331 332 333 334
		335 336 337 338 339 340 341 342 343 344 345 346 347 348 349 350 351 352 353 354 355 356 357 358 359 360 361 362
		363 364 365 366 367 368 369 370 371 372 373 374 375 376 377 378 379 380 381 382 383 384 385 386 387 388 389 390
		391 392 393 394 395 396 397 398 399 400 401 402 403 404 405 406 407 408 409 410 411 412 413 414 415 416 417 418
		419 420 421 422 423 424 425 426 427 428 429 430 431 432 433 434 435 436 437 438 439 440 441 442 443 444 445 446
		447 448 449 450 451 452 453 454 455 456 457 458 459 460 461 462 463 464 465 466 467 468 469 470 471 472 473 474
		475 476 477 478 479 480 481 482 483 484 485 486 487 488 489 490 491 492 493 494 495 496 497 498 499 500 501 502
		503 504 505 506 507 508 509 510 511 512 513 514 515 516 517 518 519 520 521 522 523 524 525 526 527 528 529 530
		531 532 533 534 535 536 537 538 539 540 541 542 543 544 545 546 547 548 549 550 551 552 553 554 555 556 557 558
		559 560 561 562 563 564 565 566 567 568 569 570 571 572 573 574 575 576 577 578 579 580 581 582 583 584 585 586
		587 588 589 590 591 592 593 594 595 596 597 598 599 600 601 602 603 604 605 606 607 608 609 611 612 613 614 615
		616 617 618 619 620 621 622 623 624 625 626 627 628 629 630 631 632 633 634 635 636 637 638 639 640 641 642 643
		644 645 646 647 648 649 650 651 652 653 654 655 656 657 659 660 661 662 663 664 665 666 667 668 669 670 671 672
		673 676 677 678 679 680 681 682 683 684 685 687 688 689 690 691 692 693 694 695 696 697 698 699 700 701 702 703
		704 705 706 707 708 709 710 711 712 713 714 715 716 717 718 719 720 721 722 723 724 725 726 727 728 729 730 731
		732 733 734 735 736 737 738 739 740 741 742 743 744 745 746 747 748 749 750 751 752 753 754 755 756 757 758 759
		760 761 762 763 764 765 766 767 768 769 770 771 772 773 774 775 776 777 778 779 780 781 782 783 784 785 786 787
		788 789 791 792 793 794 795 796 797 800 826 827 834 835 836 837 838 839 840 841 842 849 850 851 852 853 854 936
		937 938 939 940 941 942 943 944 945 946 947 948 949 950 951 952 953 954 955 956 957 958 959 960 961 962 963 964
		965 966 967 968 969 970 971 972 973 974 975 976 977 978 979 980 982 983 984 988 989 992 993 994 995 996 997 998
		999 1000 1001 1003 1004 1005 1006 1007 1008 1009 1010 1011 1012 1013 1014 1015 1016 1017 1018 1019 2533 2538 2557
		2560 2561 2567 2568 2569 2570 2577 2580 2582 2583 2584 2587 2588 2591 2632 2636 3246 
		
		1094 1095 1092 1093 1091 1090 1096 1099 1098 1101 1100 1106 1105 1104 1103 1102 1107 675 674 818 814 813 811 812 810
		817 816 809 808 815 860 858 859 828 830 829 823 822 805 798 799 804 803 802 806 807 819 820 821 824 825 831 832 833
		847 848 846 845 844 843 981 987 991 990 1023 1024 1022 985 986 2688 2689 2687 1026 1031 1029 2699 2700 1020 1027 1028
		1030 1032 1033 1034 1042 1035 1043 1044 2610 1182 1037 1025 1021 1038 1041 1036 1040 1039 1046 1047 1045 1048 1049
		1050 1051 1056 1052 1053 1054 1055 1057 130 131 138 137 103 132 133 129 105 135 136 110 92 113 114 115 125 123 124 
		111 112 91 163 185 187 186 148 167 190 182 183 181 180 178 150 165 172 179 168 169 146 184 189 173 174 188 145 147 
		160 166 171 152 151 154 191 161 175 176 159 164 144 162 143 149 155 153 41 2628 39 13 15 40 43 50 28 12 36 2596 37 
		42 2595 11 31 48 38 20 30 32 34 25 23 35 47 49 2594 156 102 95 119 117 118 120 126 97 101 94 96 134 100 121
		122 106 108 109 98 99 107 127 128 157 158 2353 2385 2352 2351 2363 2382 2354 2355 2389 2386 2374 2360 2393 2395 2384 
		2387 2388 2399 2394 2381 2398 2383 2390 2349 2350  2392 2396 2397 2391 2339 2370 2372 2369 2379 2380 2361 2365 2368 2377 
		2375 2357 2359 2362 2378 2373 2341 2376 2315 2367 2371 2337 2364 2366 2305 2322 236 237 234 141 142 2324 2403 197 2330 
		2325 2532 2401 2407 213 215 2332 2334 2400 211 214 2549 218 220 221 222 219 226 227 69 2592 2593 200 198 76 2555 206 2147 
		2142 2143 2144 2152 2312 248 238 249 247 210 209 216 2402 2326 208 2331 2262 2300 2277 2275 2284 2414 2415 2323 2328 2329 
		2313 2140 2311 2137 217 2307 2261 2301 2139 2310 2321 2141 2289 2286 2145 2278 61 65 63 64 56 58 2260 2288 62 239 2625 46 
		53 54 201 52 57 67 66 2626 2578 2308 193 2556 140 194 195 196 192 235 1979 2169 245 2287 2163 2274 2245 2246 2242 2154 2153 
		2155 2149 2157 2150 2146 2158 2159 2160 2166 2168 2148 2151 2167 790 1987 1988 1989 2006 2075 2076 2077 2012 2013 2014 2015 
		2009 2074 2574 2093 2095 2114 2101 2102 2103 2105 2106 2108 2092 2099 2112 2104 2558 2094 1990 1991 1996 1997 1998 2005 
		2008 2078 2083 2085 2086 2079 2080 2082 2107 230 231 241 242 243 229 233 1985 244 1984 1995 1986 1994 223 2279 2281 2302 2304 2299 
		2297 2296 2290 2295 2298 2292 2280 2282 2291 2294 2247 2196 2199 2251 2249 2269 2248 2252 2257 2195 2193 2194 2235 2266 2267 2276 
		2273 2253 2272 2268 2259 2265 2234 2270 2271 2254 2255 2197 2200 2239 2243 2204 2208 2202 2201 2205 1958 1972 1973 1974 2240 2241 
		2190 2250 2192 2191 2187 2188 2189 2206 2001 1982 1977 1978 2203 2258 2170 2171 2181 2182 2183 2180 2174 2184 2165
		1891 2178 1954 2129 2132 2133 2624 1983 2024 2033 2229 1999 2116 2118 2126 1895 1896 1897 2000 2098 2228 2096 2232 2100 2237 2087 2089 
		2090 2238 2088 2231 2233 2409 2223 2224 2225 2227 2179 2285 2226 2164 1888 1885 1886 1890 2111 2162 2236 2177 1889 2173 2175 2218 2220 2003
		205 202 246 2520 2542 2540 2589 2448 2314 2303 2552 2344 2546 2547 2544 2283 2551 2327 2404 2309 2348 2318 2443 2411 2412 2408 2440 2263 139 
		199 55 170 240 177 212 207 2264 2256 2548 2553 801 2526 686 86 2336 2623 2293 2545 89 2333 2161 2172 2176 2156 2185 93 204 1723 116 104 2186 2198
		44 1 45
	}
	assimilation_rate = -0.15
}

asia = {
	provinces = {
		855 856 857 861 862 863 864 865 866 867 868 869 870 871 872 873 874 875 876 877 878 879 880 881 882 883 884 885 886 
		887 888 889 890 891 892 893 894 895 896 898 899 923 924 925 926 927 928 929 930 931 932 933 934 935 1058 1059 1060 
		1061 1062 1063 1064 1065 1066 1067 1068 1069 1070 1071 1072 1073 1074 1075 1076 1077 1078 1079 1080 1081 1082 1083 
		1084 1085 1086 1087 1088 1089 1108 1109 1110 1111 1112 1113 1114 1115 1116 1117 1118 1119 1120 1121 1122 1123 1124
		1125 1126 1127 1128 1129 1130 1131 1132 1133 1134 1135 1136 1137 1138 1139 1140 1141 1142 1143 1144 1145 1146 1147
		1148 1149 1150 1151 1152 1153 1154 1155 1156 1157 1158 1159 1160 1161 1162 1163 1164 1165 1166 1167 1168 1169 1170
		1171 1172 1173 1174 1175 1176 1177 1178 1179 1180 1181 1183 1184 1185 1186 1187 1188 1189 1190 1191 1192 1193
		1194 1195 1196 1197 1198 1199 1200 1201 1202 1203 1204 1205 1206 1207 1208 1209 1210 1211 1212 1213 1214 1215 1216
		1217 1218 1219 1220 1221 1222 1223 1224 1225 1226 1227 1228 1229 1230 1231 1232 1233 1234 1235 1236 1237 1238 1239
		1240 1241 1242 1243 1244 1245 1246 1247 1248 1249 1250 1251 1252 1253 1254 1255 1256 1257 1258 1259 1260 1261 1262
		1263 1264 1265 1266 1267 1268 1269 1270 1271 1272 1273 1274 1275 1276 1277 1278 1279 1280 1281 1282 1283 1284 1285
		1286 1287 1288 1289 1290 1291 1292 1293 1294 1295 1296 1297 1298 1299 1300 1301 1302 1303 1304 1305 1306 1307 1308
		1309 1310 1311 1312 1313 1314 1315 1316 1317 1318 1319 1320 1321 1322 1323 1324 1325 1326 1327 1328 1329 1330 1331
		1332 1333 1334 1335 1336 1337 1338 1339 1340 1341 1342 1343 1344 1345 1346 1347 1348 1349 1350 1351 1352 1353 1354
		1355 1356 1357 1358 1359 1360 1361 1362 1363 1364 1365 1366 1367 1368 1369 1370 1371 1372 1373 1374 1375 1376 1377
		1378 1379 1380 1381 1382 1383 1384 1385 1386 1387 1388 1389 1390 1391 1392 1393 1394 1395 1396 1397 1398 1399 1400
		1401 1402 1403 1404 1405 1406 1407 1408 1409 1410 1411 1412 1413 1414 1415 1416 1417 1418 1419 1420 1421 1422 1423
		1424 1425 1426 1427 1428 1429 1430 1431 1432 1433 1434 1435 1436 1437 1438 1439 1440 1441 1442 1443 1444 1445 1446
		1447 1448 1449 1450 1451 1452 1453 1454 1455 1456 1457 1458 1459 1460 1461 1462 1463 1464 1465 1466 1467 1468 1469
		1470 1471 1472 1473 1474 1475 1476 1477 1478 1479 1480 1481 1482 1483 1484 1485 1486 1487 1488 1489 1490 1491 1492
		1493 1494 1495 1496 1497 1498 1499 1500 1501 1502 1503 1504 1505 1506 1507 1508 1509 1510 1511 1512 1513 1514 1515
		1516 1517 1518 1519 1520 1521 1522 1523 1524 1525 1526 1527 1528 1529 1530 1532 1533 1534 1535 1536 1537 1538 1539
		1540 1541 1542 1543 1544 1545 1546 1547 1548 1549 1550 1551 1552 1553 1554 1555 1556 1557 1558 1559 1561 1562 1563
		1564 1565 1566 1567 1568 1569 1570 1571 1572 1573 1574 1575 1576 1577 1578 1579 1580 1581 1582 1583 1584 1585 1586
		1587 1588 1589 1590 1591 1592 1593 1594 1595 1596 1597 1598 1599 1600 1601 1602 1603 1604 1605 1606 1607 1608 1609
		1610 1611 1612 1613 1614 1615 1616 1617 1618 1619 1620 1621 1622 1623 1624 1625 1626 1627 1628 1629 1630 1631 1632
		1633 1634 1635 1636 1637 1638 1639 1640 1641 1642 1643 1644 1645 1646 1647 1648 1649 1650 1651 1652 1653 1655 1656
		1657 1658 1659 1660 1661 1662 1663 1664 1665 1666 1667 1668 1669 1670 1671 1672 1673 1674 1675 1676 1677 1678 1679
		2062 2128 2207 2221 2244 2406 2562 2565 2566  2572 2575 2576 2586 2590 2606 2607 2608 2611 2612
		2613 2614 2615 2616 2617 2618 2619 2620 2621 2622 2633 2634 2637 2638 2639 2640 2641 2642 2643 2644 2645 2646 2647
		2648 2649 2650 2651 2652 2653 2654 2655 2656 2657 2658 2659 2660 2661 2662 2663 2664 2665 2666 2667 2668 2669 2670
		2671 2672 2673 2674 2675 2676 2677 2678 2679 2680 2681 2682 2683 2684 2685 2686 2690 2691 2692 2693
		2694 2695 2696 2697 2698 2701 2702 1002 26 29 33 27 7 16 6 2597 19 22 2629 80 81 82 83 84 85 87 88 90 17 18 8 10 78 
		79 9 2356 2340 2342 2358 2416 2458 2554 2306 2450 2455 2457 2460 2465 2466 2319 2452 2462 2467 2461 2463 2459 2346 
		2345 2464 2347 2451 2447 2446 2317 2437 2435 2449 2427 2434 2439 2436 2418 2320 2433 2430 2429 2431 2428 2432 2316 
		2420 2343 2338 2438 2550 2423 2600 2417 2405 2410 2424 2413 2444 2426 2425 2419 2442 2453 2456 2445 2422 2421 2441
		2509 2510 2511 2512 2513 2514 2515 2516 2571 2488 2504 2498 2486 2601 2602 2603 2483 2506 2508 2485 2487 2497 2500 
		2502 2499 2484 2491 2494 2481 2478 2473 2475 2476 2477 2479 2480 2474 2472 2469 2471 2470 225 68 250 2631 2 60 51 4 
		59 5 2627 2599 2630 3 2541 2454 2524 2536 2525 2527 2523 2535 610 658 1097 14 2519 2579 2130 2517 2518 2521 1531 1654 
		2539 2531 2529 2530 2537 2534 1560 2501 2495 2604 2505 2468 2489 2490 2492 2493 2496 2028 2016 2018 2056 
		2017 2581 2042 2045 2040 2041 2047 2058 2070 2068 2069 2635 2034 2035 2043 2046 2026 2027 2020 2021 2022 2023 2054 2055 
		2071 2064 2065 2066 2073 2605 2503 2507 224 228 21 24 1968 2115 2125 2122 2119 2124
		897 900 901 902 903 904 905 906 907 908 909 910 911 912 913 914 915 916 917 918 919 920 921 922
	}
	assimilation_rate = -0.2

}

africa = {
	provinces = {	
        1680 1681 1682 1683 1684 1685 1686 1687 1688 1689 1690 1691 1692 1693 1694 1695 1696 1697 1698
		1699 1700 1701 1702 1703 1704 1705 1706 1707 1708 1709 1710 1711 1712 1713 1714 1715 1716 1717 1718 1719 1720 1721
		1722 1724 1725 1726 1727 1728 1729 1730 1731 1732 1733 1734 1735 1736 1737 1738 1739 1740 1741 1742 1743 1744 1745
		1746 1747 1748 1749 1750 1751 1752 1753 1754 1756 1757 1758 1759 1760 1761 1762 1763 1764 1765 1766 1767 1768 1769
		1770 1771 1772 1773 1774 1775 1776 1777 1778 1779 1780 1781 1782 1783 1784 1785 1786 1787 1788 1789 1790 1791 1792
		1793 1794 1795 1796 1797 1798 1799 1800 1801 1802 1803 1804 1805 1806 1807 1808 1809 1810 1811 1812 1813 1814 1815
		1816 1817 1818 1819 1820 1821 1822 1823 1824 1825 1826 1827 1828 1829 1830 1831 1832 1833 1834 1835 1836 1837 1838
		1839 1840 1841 1842 1843 1844 1845 1846 1847 1848 1849 1850 1851 1852 1853 1854 1855 1856 1857 1858 1859 1860 1861
		1862 1863 1864 1865 1866 1867 1868 1869 1870 1871 1872 1873 1874 1875 1876 1877 1878 1879 1880 1881 1882 1883 1884
		  1887     1892 1893 1894    1898 1899 1900 1901 1902 1903 1904 1905 1906 1907
		1908 1909 1910 1911 1912 1913 1914 1915 1916 1917 1918 1919 1920 1921 1922 1923 1924 1925 1926 1927 1928 1929 1930
		1931 1932 1933 1934 1935 1936 1937 1938 1939 1940 1941 1942 1943 1944 1945 1946 1947 1948 1949 1950 1951 1952 1953
		 1955 1956 1957  1959 1960 1961 1962 1963 1964 1965 1966 1967 1969 1970 1971    1975 1976
		  1980 1981        1992 1993       
		 2002  2004  2007  2010 2011    2019    
		 2025    2029 2030 2031 2032    2036 2037 2038 2039     2044  
		 2048 2049 2050 2051 2052 2053    2057  2059 2060 2061 2063    2067   
		 2072      2081   2084       2091  
		   2097           2109 2110   2113  
		2117  2120 2121 2123  2127    2134 2135 2136  2559 2563 2564 2573 
		 2585 2609   
		1755
	}
	assimilation_rate = -0.15

}

north_america = {
	provinces = {
		        
		                     70 71 72 73 74 75  77  
	        
		  
		 
		      
	      203                    
		     232                  
		 2138                    
		                    
		                     
		  2209 2210 2211 2212 2213 2214 2215 2216 2217  2219  2222        2230
		           2598     
		 
	}
	assimilation_rate = 0.5
	farm_rgo_size = 10
	mine_rgo_size = 10
}

south_america = {
	provinces = {
	    2131                     		                      		                      		                
		       2335                                		              		   		                 
	}
	assimilation_rate = 0.5
	farm_rgo_size = 10.0
	mine_rgo_size = 10.0

}

oceania = {
	provinces = {
		                    2482
		                 
		      2522      2528
		         2543           		 
	}
	assimilation_rate = 0.5
	farm_rgo_size = 10.0
	mine_rgo_size = 10.0
}
